0 0 0 0 0 0 0 0 0 0 0 0 0 0 0 0 0 0 0 0 
0 0 0 6 0 0 0 0 0 0 0 0 0 0 0 0 0 0 0 0 
0 0 3 2 4 0 0 0 0 0 6 0 0 0 3 4 0 0 0 0 
0 0 0 0 0 0 0 0 0 3 4 0 0 0 0 2 2 0 0 0 
0 0 0 0 0 0 0 0 0 0 0 0 0 0 0 0 0 0 0 0 
0 0 0 0 0 0 0 0 0 0 0 0 0 0 0 0 0 0 3 2 
0 0 6 6 0 0 0 0 0 0 0 6 0 2 2 2 2 2 2 2 
2 2 2 2 2 2 4 0 0 0 3 2 2 2 2 2 2 2 2 2 
1 1 1 1 1 1 1 2 2 2 1 1 1 1 1 1 1 1 1 1 
1 1 1 1 1 1 1 1 1 1 1 1 1 1 1 1 1 1 1 1 
